1110111111111
1010100000001
1010111110101
1000000010101
1110111010111
1010100000100
1010111111101
1000100000101
1010101011101
1010101000001
1011101011101
1000001010001
1111111111111